16
300
83,83,83,83,83,83,83,83,83,83,83,83,83,83,83,83,83,83,83,83,83,83,83,83,83,83,83,83,83,83,83,83,83,83,83,83,83,83,83,83,83,83,83,83,83,83,83,83,83,83,83,83,83,83,83,83,83,83,83,83,83,83,83,83,83,83,83,83,83,83,83,83,83,83,83,83,83,83,83,83,83,83,83,83,83,83,83,83,83,83,83,83,83,83,83,83,83,83,83,83,83,83,83,83,83,83,83,83,83,83,83,83,83,83,83,83,83,83,83,83,83,83,83,83,83,83,83,83,83,83,83,83,83,83,83,83,83,83,83,83,83,83,83,83,83,83,83,83,83,83,83,83,83,83,83,83,83,83,83,83,83,83,83,83,83,83,83,83,83,83,83,83,83,83,83,83,83,83,83,83,83,83,83,83,83,83,83,83,83,83,83,83,83,83,83,83,83,83,83,83,83,83,83,83,83,83,83,83,83,83,83,83,83,83,83,83,83,83,83,83,83,83,83,83,83,83,83,83,83,83,83,83,83,83,83,83,83,83,83,83,83,83,83,83,83,83,83,83,83,83,83,83,83,83,83,83,83,83,83,83,83,83,83,83,83,83,83,83,83,83,83,83,83,83,83,83,83,83,83,83,44,44,44,44,44,44,44,44,44,44,44,44,44,44,44,44,44,44,19,33,
64,64,64,64,64,64,64,64,64,64,64,64,64,64,64,64,64,64,64,64,64,64,64,64,64,64,64,64,64,64,64,64,64,64,64,64,64,64,64,64,64,64,64,64,64,64,64,64,64,64,64,64,64,64,64,64,64,64,64,64,64,64,64,64,64,64,64,64,64,64,64,64,64,64,64,64,64,64,64,64,64,64,64,64,64,64,64,64,64,64,64,64,64,64,64,64,64,64,64,64,64,64,64,64,64,64,64,64,64,64,64,64,64,64,64,64,64,64,64,64,64,64,64,64,64,64,64,64,64,64,64,64,64,64,64,64,64,64,64,64,64,64,64,64,64,64,64,64,64,64,64,64,64,64,64,64,64,64,64,64,64,64,64,64,64,64,64,64,64,64,64,64,64,64,64,64,64,64,64,64,64,64,64,64,64,64,64,64,64,64,64,64,64,64,64,64,64,64,64,64,64,64,64,64,64,64,64,64,64,64,64,64,64,64,64,64,64,64,64,64,64,64,64,64,64,64,64,64,64,64,64,64,64,64,64,64,64,64,64,64,64,64,64,64,64,64,64,64,64,64,64,64,64,64,64,64,64,64,64,64,64,64,64,64,64,64,64,64,64,64,64,64,64,64,64,64,64,64,64,64,44,44,44,44,44,44,44,44,44,44,44,44,44,44,44,44,44,44,36,57,
44,44,44,44,44,44,44,44,44,44,44,44,65,66,65,66,67,44,44,44,44,44,44,44,44,44,44,44,44,44,44,44,44,44,44,44,44,44,44,44,44,44,44,44,44,44,44,44,44,44,44,44,65,66,65,66,67,44,44,44,44,44,44,44,44,44,44,44,44,44,44,44,44,44,44,44,44,44,44,44,44,44,44,44,44,44,44,44,44,44,44,44,44,44,44,44,44,44,44,44,44,44,44,44,44,44,44,44,44,44,44,44,65,66,65,66,67,44,44,44,44,44,44,44,44,44,44,44,129,129,44,44,44,44,44,44,44,65,66,67,44,44,44,44,44,44,44,44,44,44,44,44,65,66,65,66,67,44,44,44,44,44,44,44,44,44,44,44,44,44,44,44,44,44,44,44,44,44,44,44,44,44,44,44,44,44,44,44,44,44,44,44,44,44,44,44,44,44,44,44,44,44,44,44,44,44,44,44,44,44,44,44,44,44,44,44,44,44,44,44,44,44,44,44,44,44,44,44,44,44,44,44,65,66,65,66,67,44,44,44,44,44,44,44,44,44,44,44,44,44,44,44,44,44,44,44,44,44,44,44,44,65,66,67,44,44,44,44,44,44,44,44,44,44,99,99,44,44,44,44,44,44,44,44,44,44,44,44,44,44,44,44,44,44,44,44,44,142,143,142,
44,44,44,44,44,44,44,44,44,44,44,68,69,70,69,70,71,44,44,44,44,44,44,44,44,44,44,44,44,44,44,44,44,44,44,44,44,65,66,67,44,44,44,44,44,44,44,44,44,44,44,68,69,70,69,70,71,44,44,44,44,44,44,44,44,44,44,44,44,44,44,44,44,44,44,44,44,44,44,44,44,44,44,44,44,44,44,244,44,44,44,44,44,44,44,44,44,44,44,44,44,44,44,44,44,44,44,44,44,44,44,68,69,70,69,70,71,44,44,44,44,44,44,44,44,44,44,44,44,44,44,44,44,44,44,44,68,69,70,71,44,44,44,44,44,44,44,44,44,44,44,68,69,70,69,70,71,44,44,44,44,44,44,44,44,44,44,44,44,44,44,44,44,44,44,44,44,65,66,67,44,44,44,44,44,44,44,44,44,44,44,44,44,44,44,44,44,44,44,44,44,44,44,44,44,44,44,44,44,44,44,44,44,44,44,44,44,65,66,67,44,44,44,44,44,44,44,44,44,44,44,68,69,70,69,70,71,44,44,44,44,44,44,44,44,44,44,44,44,44,44,44,44,44,44,44,44,44,44,44,68,69,70,71,44,44,44,44,44,44,44,44,44,99,99,99,44,244,44,44,44,44,44,44,44,44,44,44,44,44,44,44,44,44,44,44,44,44,142,143,
44,44,44,44,44,44,44,44,44,44,44,44,44,44,44,44,44,44,44,44,44,44,44,44,44,44,44,44,44,44,44,44,44,44,44,44,68,69,70,71,44,44,44,44,44,44,44,44,44,44,44,44,44,44,44,44,44,44,44,44,44,44,44,44,44,44,44,44,44,44,44,44,44,44,44,44,44,44,44,44,44,44,44,44,44,44,44,244,44,44,44,44,44,44,44,44,44,44,44,44,44,44,44,44,44,44,44,44,44,44,44,44,44,44,44,44,44,44,44,44,44,44,44,44,44,44,44,44,44,44,44,44,44,44,44,44,44,44,44,44,44,44,44,44,44,44,44,44,44,44,44,44,44,44,44,44,44,44,44,44,44,44,44,44,44,44,44,44,44,44,44,44,44,44,44,44,68,69,70,71,44,44,44,44,44,44,44,44,44,44,44,44,44,44,44,44,44,44,44,44,44,44,44,44,44,44,44,44,44,44,44,44,44,44,44,44,68,69,70,71,44,44,44,44,44,44,44,44,44,44,44,44,44,44,44,44,44,44,44,44,44,44,44,44,44,44,44,44,44,44,44,44,44,44,44,44,44,44,44,44,44,44,44,44,44,44,44,44,44,44,44,44,99,99,99,99,44,44,44,44,44,44,44,44,44,44,44,44,44,44,44,44,44,44,44,44,44,44,142,143,
44,44,44,44,44,44,44,44,44,44,44,44,44,44,44,44,44,44,44,44,44,44,44,44,44,44,44,44,44,44,44,44,44,44,44,44,44,44,44,44,44,44,44,44,44,44,44,44,44,44,44,44,44,44,44,44,44,44,44,44,44,44,44,44,44,44,44,44,44,44,44,44,44,44,44,44,44,44,44,44,130,130,130,128,130,130,44,244,44,44,44,44,44,44,44,44,44,44,44,44,44,44,44,44,44,44,44,44,44,44,44,44,44,44,44,44,44,44,44,44,44,44,44,44,44,44,44,44,54,94,44,44,44,44,44,44,44,44,44,44,44,44,44,44,44,44,44,44,44,44,44,44,44,44,44,44,44,44,44,44,44,44,44,44,44,44,44,44,44,44,44,44,44,44,44,44,44,44,44,44,44,44,44,44,44,44,44,44,44,44,44,44,44,44,44,44,44,44,44,44,44,44,44,44,44,44,44,44,44,44,44,44,44,44,44,44,44,44,44,44,44,44,44,44,44,44,44,44,44,44,44,44,44,44,44,44,44,44,44,44,44,44,44,44,44,44,44,44,44,44,44,54,94,44,44,44,44,44,44,44,44,44,44,44,44,44,44,54,94,44,44,99,99,99,99,99,44,244,44,44,44,44,44,44,44,44,44,44,44,44,44,44,44,44,44,44,44,44,142,143,
44,44,44,44,44,44,44,44,44,44,44,44,44,44,44,44,44,44,44,44,44,44,44,44,44,44,44,44,44,44,44,44,44,44,129,44,44,44,44,44,44,44,44,44,44,44,44,44,44,44,44,44,44,44,44,44,44,44,44,44,44,44,44,44,44,44,44,44,44,44,44,44,44,44,44,44,44,44,44,44,44,44,44,44,44,44,44,244,44,44,44,44,44,44,44,129,44,44,44,44,44,44,44,44,44,44,44,44,44,44,44,44,44,44,44,44,44,44,44,44,44,44,44,44,44,44,129,129,129,129,129,129,44,44,44,44,44,44,44,44,44,44,44,44,44,44,44,44,44,44,44,44,44,44,44,44,44,44,44,44,44,44,44,44,44,44,44,44,44,44,44,44,44,44,129,44,44,44,44,44,44,44,44,44,44,44,44,44,44,44,44,44,44,44,44,44,44,44,44,44,44,44,44,44,44,44,44,44,44,44,44,44,44,44,129,44,44,44,44,44,44,44,44,44,44,44,44,44,44,44,44,44,44,44,44,44,44,44,44,44,44,44,44,44,44,44,44,44,44,44,54,44,44,94,44,44,44,44,44,44,44,44,44,44,44,44,54,44,44,94,99,99,99,99,99,99,44,44,44,44,44,44,44,44,44,44,44,44,44,44,44,44,44,44,44,44,44,44,142,143,
44,44,44,44,44,44,44,44,54,94,44,44,44,44,44,44,44,44,44,44,44,44,44,44,44,44,44,44,44,44,44,44,44,44,44,44,44,44,44,44,44,44,44,44,44,44,44,44,54,94,44,44,44,44,44,44,44,44,44,44,44,44,44,44,44,44,44,129,130,129,130,129,44,44,44,44,44,44,112,113,44,44,44,44,44,44,44,244,44,44,44,44,44,44,44,44,44,44,44,44,44,44,44,44,44,44,44,44,54,94,44,44,44,44,44,44,44,44,44,44,44,44,44,44,44,44,54,44,44,44,44,94,44,44,44,44,44,44,44,44,44,44,44,44,44,44,44,44,54,94,44,44,44,44,44,44,44,44,44,44,44,44,44,44,44,44,44,44,44,44,44,44,44,44,44,44,44,44,44,44,44,44,44,44,44,44,44,129,130,129,130,129,44,44,44,44,44,44,112,113,44,44,44,44,44,44,44,44,44,44,44,44,44,44,44,44,44,44,44,44,44,44,44,44,44,44,44,44,54,94,44,44,44,44,44,44,44,44,44,44,44,44,44,44,44,44,44,44,44,54,44,44,44,44,94,44,44,130,130,128,44,44,44,44,44,54,44,44,44,99,99,99,99,99,99,99,44,244,44,44,44,44,44,44,44,44,44,44,44,44,44,44,44,44,44,44,44,44,142,143,
44,44,44,44,44,44,44,54,44,44,94,44,44,44,44,44,44,44,44,44,44,44,44,44,44,44,44,44,44,44,44,44,44,54,94,44,44,44,44,44,44,44,44,44,44,44,44,54,44,44,94,44,44,44,44,44,44,44,44,44,44,44,44,44,44,44,44,44,44,44,44,44,44,44,44,44,44,44,114,115,44,44,44,44,44,44,44,244,44,44,44,44,44,44,44,44,44,44,44,44,44,44,44,44,44,44,44,54,44,44,94,44,44,44,44,44,44,44,44,44,44,44,44,44,44,54,44,44,44,44,44,44,94,44,44,44,44,44,44,44,44,44,44,44,44,44,44,54,44,44,94,44,44,44,44,44,44,44,44,44,44,44,44,44,44,44,44,44,44,44,44,44,44,54,94,44,44,44,44,44,44,44,44,44,44,44,44,44,44,44,44,44,44,44,44,44,44,44,114,115,44,44,44,44,44,44,44,44,44,44,44,44,44,54,94,44,44,44,44,44,44,44,44,44,44,44,44,54,44,44,94,44,44,44,44,44,44,44,44,44,44,44,44,44,44,44,44,44,54,44,44,44,44,44,44,94,44,44,44,44,44,44,44,44,54,44,44,44,44,44,244,94,244,44,244,44,44,44,44,44,44,44,44,44,44,44,44,44,44,44,44,44,44,44,44,44,44,44,142,143,
44,44,44,44,44,129,54,44,44,44,44,94,44,44,44,44,44,44,44,44,44,44,129,44,44,44,44,44,44,44,50,51,54,44,44,94,44,44,44,44,44,44,44,44,44,129,54,44,44,44,44,94,44,44,44,44,44,44,44,44,44,44,44,44,44,44,44,44,44,44,44,44,44,44,44,44,44,44,114,115,44,44,44,44,44,44,44,244,44,44,44,44,44,44,44,44,44,44,44,44,44,44,44,44,44,129,54,44,44,44,44,94,44,44,44,44,44,44,44,44,44,44,44,44,54,44,44,44,44,44,44,44,44,94,44,44,44,44,44,44,44,44,44,44,44,129,54,44,44,44,44,94,44,44,44,44,44,44,44,44,44,44,129,44,44,44,44,44,44,44,50,51,54,44,44,94,44,44,44,44,44,44,44,44,44,44,44,44,44,44,44,44,44,44,44,44,44,44,114,115,44,44,129,44,44,44,44,44,44,44,50,51,54,44,44,94,44,44,44,44,44,44,44,44,44,129,54,44,44,44,44,94,44,44,44,44,44,44,44,44,44,44,44,44,44,44,44,54,44,44,44,44,44,44,44,44,94,44,44,44,44,44,44,54,44,44,44,99,99,99,99,99,99,99,99,99,44,244,44,44,44,44,44,44,44,44,44,44,44,44,44,44,44,44,44,44,44,44,142,143,
44,44,44,44,44,54,44,44,44,44,44,44,94,44,44,44,44,44,44,44,44,44,44,44,44,44,44,44,44,44,82,54,44,44,44,44,94,44,44,44,44,44,44,44,44,54,44,44,44,44,44,44,94,44,44,44,44,44,44,44,44,54,94,44,54,94,44,44,44,44,44,44,44,44,44,44,44,44,114,115,44,44,129,44,44,44,44,44,44,44,44,44,44,44,130,130,130,44,44,44,44,44,44,44,44,54,44,44,44,44,44,44,94,44,44,44,44,44,44,44,44,44,44,54,127,127,127,127,127,127,127,127,127,127,94,44,44,44,44,44,44,44,44,44,44,54,44,44,44,44,44,44,94,44,44,44,44,44,44,44,44,44,44,44,44,44,44,44,44,44,82,54,44,44,44,44,94,44,44,44,44,54,94,44,54,94,44,44,44,44,44,44,44,44,44,44,44,44,114,115,44,44,44,44,44,44,44,44,44,44,82,54,44,44,44,44,94,44,44,44,44,44,44,44,44,54,44,44,44,44,44,44,94,44,44,44,44,44,44,44,44,44,50,51,44,44,54,44,44,44,72,73,44,44,44,44,44,94,44,44,44,44,54,44,44,44,99,99,99,99,99,99,99,99,99,99,44,44,44,44,44,44,44,44,44,44,44,44,44,44,44,44,44,44,44,44,44,44,142,143,
44,44,54,94,54,44,44,44,44,50,51,44,44,94,44,44,44,44,44,44,44,44,44,44,44,44,44,44,44,44,52,44,44,44,99,99,44,94,44,44,44,44,54,94,54,44,44,44,44,50,51,44,44,94,44,44,44,44,44,44,82,96,96,96,96,96,96,96,96,96,96,96,96,96,96,96,96,96,96,96,44,44,44,50,51,44,44,44,44,44,44,44,44,44,44,44,44,44,44,44,44,44,54,94,54,44,44,44,44,50,51,44,44,94,44,44,44,44,44,44,44,44,54,44,44,44,44,44,44,44,44,44,44,44,44,94,50,51,44,44,44,44,54,94,54,44,44,44,44,50,51,44,44,94,44,44,44,44,44,44,44,44,44,44,44,44,44,44,44,44,52,44,44,44,99,99,44,94,44,44,82,96,96,96,96,96,96,96,96,96,96,96,96,96,96,96,96,96,96,96,44,44,44,44,44,44,44,44,44,44,52,44,44,44,99,99,44,94,44,44,44,44,54,94,54,44,44,44,44,50,51,44,44,94,44,44,44,44,44,44,50,51,49,54,94,54,44,44,44,44,74,75,76,44,44,99,99,99,99,99,99,54,44,44,44,44,244,44,244,44,244,99,99,99,99,99,44,244,44,44,44,44,44,44,44,44,44,44,44,44,44,44,44,44,44,44,44,44,142,143,
44,112,113,44,94,44,44,50,51,49,44,44,44,44,94,44,44,44,44,44,44,44,44,44,44,44,44,112,113,54,82,44,44,44,99,99,44,44,94,44,44,112,113,44,94,44,44,50,51,49,44,44,44,44,94,44,44,44,44,44,82,232,232,232,232,232,232,232,232,232,232,232,232,232,232,232,232,232,232,232,44,50,51,49,44,44,44,44,44,44,44,44,44,44,44,44,44,44,44,44,44,112,113,44,94,44,44,50,51,49,44,44,44,44,94,44,44,44,44,44,44,54,44,44,44,44,44,44,44,44,44,44,44,44,50,51,60,44,44,44,44,112,113,44,94,44,44,50,51,49,44,44,44,44,94,44,44,44,44,44,44,44,44,44,44,44,44,112,113,54,82,44,44,44,99,99,44,44,94,44,82,232,232,232,232,232,232,232,232,232,232,232,232,232,232,232,232,232,232,232,44,44,44,44,44,44,44,112,113,54,82,44,44,44,99,99,44,44,94,44,44,112,113,44,94,44,44,50,51,49,44,44,44,44,94,44,44,44,44,44,49,44,52,44,44,94,44,44,44,44,99,99,99,99,99,99,99,99,99,99,99,44,44,44,99,99,99,99,99,99,99,99,99,99,99,99,44,44,44,44,44,44,44,44,44,44,44,44,44,44,44,44,44,44,44,44,44,44,142,143,
54,114,115,44,44,94,44,49,44,49,44,44,44,44,44,94,44,44,44,44,44,44,44,44,44,44,44,114,115,44,82,44,44,44,99,99,44,44,44,94,54,114,115,44,44,94,44,49,44,49,44,44,44,44,44,94,44,44,44,44,82,232,232,232,232,232,232,232,232,232,232,232,232,232,232,232,232,232,232,232,44,49,44,49,44,44,44,44,44,44,44,44,44,44,44,44,44,44,44,44,54,114,115,44,44,94,44,49,44,49,44,44,44,44,44,94,44,44,44,44,54,44,44,44,44,44,44,44,44,44,44,44,44,44,49,44,49,94,44,44,54,114,115,44,44,94,44,49,44,49,44,44,44,44,44,94,44,44,44,44,44,44,44,44,44,44,44,114,115,44,82,44,44,44,99,99,44,44,44,94,82,232,232,232,232,232,232,232,232,232,232,232,232,232,232,232,232,232,232,232,44,44,44,44,44,44,44,114,115,44,82,44,44,44,99,99,44,44,44,94,54,114,115,44,44,94,44,49,44,49,44,44,44,44,44,94,44,44,44,44,49,54,49,44,44,44,94,44,44,44,99,99,99,99,99,99,99,99,99,99,99,44,44,99,99,99,99,99,99,99,99,99,99,99,99,99,94,44,44,44,44,44,44,44,44,44,44,44,44,44,44,44,44,44,44,44,44,44,19,33,
96,96,96,96,96,96,96,96,96,96,96,96,96,96,96,96,96,96,96,96,96,96,96,96,96,96,96,96,96,96,96,96,96,96,96,96,96,96,96,96,96,96,96,96,96,96,96,96,96,96,96,96,96,96,96,96,96,96,96,96,96,232,232,232,232,232,232,232,232,232,232,232,232,232,232,232,232,232,232,232,96,96,96,96,96,96,96,96,96,80,82,96,96,96,96,96,96,96,96,96,96,96,96,96,96,96,96,96,96,96,96,96,96,96,96,96,96,96,96,96,96,96,96,96,96,96,96,96,96,96,96,96,96,96,96,96,96,96,80,44,96,96,96,96,96,96,96,96,96,96,96,96,96,96,96,96,96,96,96,96,96,96,96,96,96,96,96,96,96,96,96,96,96,96,96,96,96,96,96,96,96,232,232,232,232,232,232,232,232,232,232,232,232,232,232,232,232,232,232,232,96,96,96,96,96,96,96,96,96,96,96,96,96,96,96,96,96,96,96,96,96,96,96,96,96,96,96,96,96,96,96,96,96,96,96,96,96,96,96,96,96,96,96,96,96,96,96,80,44,82,96,96,96,96,96,96,96,96,96,96,96,80,82,96,96,96,96,96,96,96,96,96,96,96,96,96,96,96,96,96,44,44,44,44,44,44,44,44,44,44,44,44,44,44,44,44,44,44,36,57,
97,97,97,97,97,97,97,97,97,97,97,97,97,97,97,97,97,97,97,97,97,97,97,97,97,97,97,97,97,97,97,97,97,97,97,97,97,97,97,97,97,97,97,97,97,97,97,97,97,97,97,97,97,97,97,97,97,97,97,97,97,97,97,97,97,97,97,97,97,97,97,97,97,97,97,97,97,97,97,97,97,97,97,97,97,97,97,97,97,80,82,97,97,97,97,97,97,97,97,97,97,97,97,97,97,97,97,97,97,97,97,97,97,97,97,97,97,97,97,97,97,97,97,97,97,97,97,97,97,97,97,97,97,97,97,97,97,97,80,44,97,97,97,97,97,97,97,97,97,97,97,97,97,97,97,97,97,97,97,97,97,97,97,97,97,97,97,97,97,97,97,97,97,97,97,97,97,97,97,97,97,97,97,97,97,97,97,97,97,97,97,97,97,97,97,97,97,97,97,97,97,97,97,97,97,97,97,97,97,97,97,97,97,97,97,97,97,97,97,97,97,97,97,97,97,97,97,97,97,97,97,97,97,97,97,97,97,97,97,97,97,97,97,97,97,97,97,80,44,82,97,97,97,97,97,97,97,97,97,97,97,80,82,97,97,97,97,97,97,97,97,97,97,97,97,97,97,97,97,97,142,143,142,143,142,143,142,143,142,143,142,143,142,143,142,143,142,143,142,143