0,0,0,0,0,0,0,0,0,0,0,0,0,0,0,0,
0,0,0,0,0,0,0,0,0,0,0,0,0,0,0,0,
8,8,8,8,8,8,0,0,0,0,8,8,8,8,8,8,
0,0,0,0,0,0,0,0,0,0,0,0,0,0,0,0,
0,0,0,0,0,0,0,0,0,0,0,0,0,0,0,0,
0,0,0,0,8,8,8,8,8,8,8,8,0,0,0,0,
8,8,0,0,0,0,0,0,0,0,0,0,0,0,8,8,
0,0,0,0,0,0,0,0,0,0,0,0,0,0,0,0,
0,0,0,0,0,0,0,9,9,0,0,0,0,0,0,0,
8,8,8,8,8,8,0,0,0,0,8,8,8,8,8,8,
7,5,0,0,0,0,0,0,0,0,0,0,0,0,3,7,
6,4,0,0,0,0,0,0,0,0,0,0,0,0,2,6,
1,1,1,1,1,1,1,1,1,1,1,1,1,1,1,1